1111111
1000001
1000001
10a0001
1000001
1111111
