1111111111111
1010001000101
1010101010101
1010101010101
1010101010101
1010101010101
1010101010101
1010101010101
1010101010101
1010101010101
1010101010101
1010101010101
1010101010101
1010101010101
1010101010101
1010101010101
1010101010101
1010101010101
1000100010001
1111111111111
