1111111111
1111111111
1111000001
1000000001
1000000001
1000000001
1000000001
1111111111
