111111111
100000001
100131001
100000001
100000001
100000001
100000301
111111111
