1111111111
1000000001
1001100011
1010000101
1001100001
1000000001
1111111111
