111111111111111111111111111111
111v11111111111111111111111111
111011111111111111111111111111
100000111111111111111111111111
120002111111111111111111111111
100000111111111111111111111111
100000111111111111111111111111
120002111111111111111111111111
100000111111111111111111111111
100000111111111111111111111111
120002111111111111111111111111
100000111111111111111111111111
100000111111111111111111111111
120002111111111111111111111111
100000111111111111111111111111
100000111111111111111111111111
120002111111111111111111111111
100000111111111111111111111111
100000111111111111111111111111
120002111111111111111111111111
100000111111111111111111111111
100000020020020020020020000001
1200000000000000000000000000n1
1000000000000000000000000000n1
1000000000000000000000000000n1
120000020020020020020020000001
100000111111111111111111111111
120002111111111111111111111111
100000111111111111111111111111
100000111111111111111111111111
120002111111111111111111111111
100000111111111111111111111111
100000111111111111111111111111
120002111111111111111111111111
122222111111111111111111111111
