111111111111111111
111111110011111111
100000000000000001
100000000000000001
100000000000000001
111111110111111111
100010010100011111
101011010100000111
101000010100010101
101101110110110101
101000000110110001
101011110110110101
101010000000110101
101010111111110101
101011111111110101
100010111000000101
101110111011111101
100000111111000001
111111111111011111
100000000000000001
100000000000000001
100000000000000001
100000000000000001
100000000000000001
111111111111111111
