1111112111111111111111111111111111111111111111
1000000000000000111111000000000000000000000001
1000100000000000111111000000000000000000000001
1000100000000000111n11000000000000000000000001
1111100111111000111011110000000000000000000001
1000000000011000100000010000000000000000000001
1000100100011101100000011111110001111000000001
1000100100010000000000011111111111001000000001
1111100111110000000000000000010001001000000001
1000000000010000000000011111010000001000000001
1000100100010000000000021001020000001000000001
100010^100011111110111111001010000001000000001
1111111111111100000000011001000000101000000001
1000000000011101000001011001111121111000000001
1000000000011101000001011000000000000000000001
1000000000011101000001011000000000000000000001
1000000000011101000001011000000000000000000001
1000000000011101000001011000000000000000000001
1000000000011100000000011000000000000000000001
1000000000011100000000011000000000000000000001
1000000000011100111110011000000000000000000001
1000000000011111111111111000000000000000000001
1000000000010000000000000000000000000000000001
1000000000000000000000000000000000000000000001
1000000000000000000000000000000000000000000001
1111111111111111111111111111111111111111111111
